11111111111111111111111
10010000000000000000001
10000111110010000011101
1P0011E0T0001100T000001
1000000C00000C000000001
10C00000000E000000T0001
1000000C00000T00000E001
10000000000000000000001
11111111111111111111111
