11111111111111111111111
10010000T00000000000001
10000111110010000011101
1P0011E0000011000000001
1000000C00000C0T0000001
10C00000000000000000001
1000000C00000T000000001
1000000000000000000T001
11111111111111111111111
