11111111111111111111111111111
10010000000C00000000000000001
10000111110010000000111100001
1P0011E0000011000000000000001
11111111111111111111111111111