111111111111111111111111111
100100000000000000000000001
100001111100100000111100001
1P0011E00000110000000000001
1000000C00000C0000000000001
10C00000000E0000000000E0001
1000000C00000000000E0000001
111111111111111111111111111